AuraRingArcane=Aura/AuraRing/AuraRingArcane
AuraRingEarth=Aura/AuraRing/AuraRingEarth
AuraRingFire=Aura/AuraRing/AuraRingFire
AuraRingFrost=Aura/AuraRing/AuraRingFrost
AuraRingLife=Aura/AuraRing/AuraRingLife
AuraRingLight=Aura/AuraRing/AuraRingLight
AuraRingLightning=Aura/AuraRing/AuraRingLightning
AuraRingShadow=Aura/AuraRing/AuraRingShadow
AuraRingStorm=Aura/AuraRing/AuraRingStorm
AuraRingWater=Aura/AuraRing/AuraRingWater
AuraActivateArcane=Aura/Legacy/Arcane/AuraActivateArcane
AuraArcane=Aura/Legacy/Arcane/AuraArcane
AuraDisableArcane=Aura/Legacy/Arcane/AuraDisableArcane
GroundArcane=Aura/Legacy/Arcane/GroundArcane
AuraActivateEarth=Aura/Legacy/Earth/AuraActivateEarth
AuraDisableEarth=Aura/Legacy/Earth/AuraDisableEarth
AuraEarth=Aura/Legacy/Earth/AuraEarth
GroundEarth=Aura/Legacy/Earth/GroundEarth
GroundEarth2=Aura/Legacy/Earth/GroundEarth2
AuraActivateFire=Aura/Legacy/Fire/AuraActivateFire
AuraDisableFire=Aura/Legacy/Fire/AuraDisableFire
AuraFire=Aura/Legacy/Fire/AuraFire
GroundFire=Aura/Legacy/Fire/GroundFire
AuraActivateFrost=Aura/Legacy/Frost/AuraActivateFrost
AuraDisableFrost=Aura/Legacy/Frost/AuraDisableFrost
AuraFrost=Aura/Legacy/Frost/AuraFrost
GroundFrost=Aura/Legacy/Frost/GroundFrost
AuraActivateLife=Aura/Legacy/Life/AuraActivateLife
AuraDisableLife=Aura/Legacy/Life/AuraDisableLife
AuraLife=Aura/Legacy/Life/AuraLife
GroundLife=Aura/Legacy/Life/GroundLife
AuraActivateLight=Aura/Legacy/Light/AuraActivateLight
AuraDisableLight=Aura/Legacy/Light/AuraDisableLight
AuraLight=Aura/Legacy/Light/AuraLight
GroundLight=Aura/Legacy/Light/GroundLight
AuraActivateLightning=Aura/Legacy/Lightning/AuraActivateLightning
AuraDisableLightning=Aura/Legacy/Lightning/AuraDisableLightning
AuraLightning=Aura/Legacy/Lightning/AuraLightning
GroundLightning=Aura/Legacy/Lightning/GroundLightning
AuraActivateModular=Aura/Legacy/Modular/AuraActivateModular
AuraDisableModular=Aura/Legacy/Modular/AuraDisableModular
AuraModular=Aura/Legacy/Modular/AuraModular
GroundModular=Aura/Legacy/Modular/GroundModular
GroundModular2=Aura/Legacy/Modular/GroundModular2
AuraActivateShadow=Aura/Legacy/Shadow/AuraActivateShadow
AuraDisableShadow=Aura/Legacy/Shadow/AuraDisableShadow
AuraShadow=Aura/Legacy/Shadow/AuraShadow
GroundShadow=Aura/Legacy/Shadow/GroundShadow
AuraActivateStorm=Aura/Legacy/Storm/AuraActivateStorm
AuraDisableStorm=Aura/Legacy/Storm/AuraDisableStorm
AuraStorm=Aura/Legacy/Storm/AuraStorm
GroundStorm=Aura/Legacy/Storm/GroundStorm
AuraActivateWater=Aura/Legacy/Water/AuraActivateWater
AuraDisableWater=Aura/Legacy/Water/AuraDisableWater
AuraWater=Aura/Legacy/Water/AuraWater
GroundWater=Aura/Legacy/Water/GroundWater
SpinningArcane=Aura/SpinningAura/SpinningArcane
SpinningEarth=Aura/SpinningAura/SpinningEarth
SpinningFire=Aura/SpinningAura/SpinningFire
SpinningFrost=Aura/SpinningAura/SpinningFrost
SpinningLife=Aura/SpinningAura/SpinningLife
SpinningLight=Aura/SpinningAura/SpinningLight
SpinningLightning=Aura/SpinningAura/SpinningLightning
SpinningModular=Aura/SpinningAura/SpinningModular
SpinningShadow=Aura/SpinningAura/SpinningShadow
SpinningStorm=Aura/SpinningAura/SpinningStorm
SpinningWater=Aura/SpinningAura/SpinningWater
Arcane Beam=Beams/Beam/Arcane Beam
Earth Beam=Beams/Beam/Earth Beam
Fire Beam=Beams/Beam/Fire Beam
Frost Beam=Beams/Beam/Frost Beam
Life Beam=Beams/Beam/Life Beam
Light Beam=Beams/Beam/Light Beam
Lightning Beam=Beams/Beam/Lightning Beam
Shadow Beam=Beams/Beam/Shadow Beam
Storm Beam=Beams/Beam/Storm Beam
Water Beam=Beams/Beam/Water Beam
ArcaneBeamImpact=Beams/Impact/ArcaneBeamImpact
EarthBeamImpact=Beams/Impact/EarthBeamImpact
FireBeamImpact=Beams/Impact/FireBeamImpact
FrostBeamImpact=Beams/Impact/FrostBeamImpact
LifeBeamImpact=Beams/Impact/LifeBeamImpact
LightBeamImpact=Beams/Impact/LightBeamImpact
LightningBeamImpact=Beams/Impact/LightningBeamImpact
ShadowBeamImpact=Beams/Impact/ShadowBeamImpact
StormBeamImpact=Beams/Impact/StormBeamImpact
WaterBeamImpact=Beams/Impact/WaterBeamImpact
ArcaneBeamStart=Beams/Start/ArcaneBeamStart
EarthBeamStart=Beams/Start/EarthBeamStart
FireBeamStart=Beams/Start/FireBeamStart
FrostBeamStart=Beams/Start/FrostBeamStart
LifeBeamStart=Beams/Start/LifeBeamStart
LightBeamStart=Beams/Start/LightBeamStart
LightningBeamStart=Beams/Start/LightningBeamStart
ShadowBeamStart=Beams/Start/ShadowBeamStart
StormBeamStart=Beams/Start/StormBeamStart
WaterBeamStart=Beams/Start/WaterBeamStart
ArcaneCharge=Charge/ArcaneCharge
EarthCharge=Charge/EarthCharge
FireCharge=Charge/FireCharge
FrostCharge=Charge/FrostCharge
LifeCharge=Charge/LifeCharge
LightCharge=Charge/LightCharge
LightningCharge=Charge/LightningCharge
ShadowCharge=Charge/ShadowCharge
StormCharge=Charge/StormCharge
WaterCharge=Charge/WaterCharge
ArcaneCleave=Cleave/ArcaneCleave
EarthCleave=Cleave/EarthCleave
FireCleave=Cleave/FireCleave
FrostCleave=Cleave/FrostCleave
LifeCleave=Cleave/LifeCleave
LightCleave=Cleave/LightCleave
LightningCleave=Cleave/LightningCleave
ShadowCleave=Cleave/ShadowCleave
StormCleave=Cleave/StormCleave
WaterCleave=Cleave/WaterCleave
DamageOverTimeArcane=DamageOverTime/DamageOverTimeArcane
DamageOverTimeEarth=DamageOverTime/DamageOverTimeEarth
DamageOverTimeFire=DamageOverTime/DamageOverTimeFire
DamageOverTimeFrost=DamageOverTime/DamageOverTimeFrost
DamageOverTimeLife=DamageOverTime/DamageOverTimeLife
DamageOverTimeLight=DamageOverTime/DamageOverTimeLight
DamageOverTimeLightning=DamageOverTime/DamageOverTimeLightning
DamageOverTimeShadow=DamageOverTime/DamageOverTimeShadow
DamageOverTimeStorm=DamageOverTime/DamageOverTimeStorm
DamageOverTimeWater=DamageOverTime/DamageOverTimeWater
VariantDamageOverTimeFire=DamageOverTime/VariantDamageOverTimeFire
ArcaneEnchant=Enchant/ArcaneEnchant
EarthEnchant=Enchant/EarthEnchant
FireEnchant=Enchant/FireEnchant
FrostEnchant=Enchant/FrostEnchant
LifeEnchant=Enchant/LifeEnchant
LightEnchant=Enchant/LightEnchant
LightningEnchant=Enchant/LightningEnchant
ShadowEnchant=Enchant/ShadowEnchant
StormEnchant=Enchant/StormEnchant
WaterEnchant=Enchant/WaterEnchant
ArcaneMeshGlow=MeshGlow/ArcaneMeshGlow
EarthMeshGlow=MeshGlow/EarthMeshGlow
FireMeshGlow=MeshGlow/FireMeshGlow
FrostMeshGlow=MeshGlow/FrostMeshGlow
LifeMeshGlow=MeshGlow/LifeMeshGlow
LightMeshGlow=MeshGlow/LightMeshGlow
LightningMeshGlow=MeshGlow/LightningMeshGlow
ShadowMeshGlow=MeshGlow/ShadowMeshGlow
SphereGlowArcane=MeshGlow/SphereGlowArcane
StormMeshGlow=MeshGlow/StormMeshGlow
WaterMeshGlow=MeshGlow/WaterMeshGlow
ElegantSparks 1=Modular/ElegantSparks 1
ElegantSparks=Modular/ElegantSparks
FastBigPop=Modular/FastBigPop
GlowExplosion=Modular/GlowExplosion
GoldLightning=Modular/GoldLightning
GreenLightning=Modular/GreenLightning
HollowSmoke=Modular/HollowSmoke
MezmerisingDust=Modular/MezmerisingDust
SmoothPop=Modular/SmoothPop
SnowSmoke=Modular/SnowSmoke
SparklyFade=Modular/SparklyFade
SpikyConfetti=Modular/SpikyConfetti
SpikySparks=Modular/SpikySparks
TwirlyPlasmaCloud=Modular/TwirlyPlasmaCloud
UnstableCharge=Modular/UnstableCharge
ArcaneMuzzleBig=Muzzleflash/Big/ArcaneMuzzleBig
EarthMuzzleBig=Muzzleflash/Big/EarthMuzzleBig
FireMuzzleBig=Muzzleflash/Big/FireMuzzleBig
FrostMuzzleBig=Muzzleflash/Big/FrostMuzzleBig
LifeMuzzleBig=Muzzleflash/Big/LifeMuzzleBig
LightMuzzleBig=Muzzleflash/Big/LightMuzzleBig
LightningMuzzleBig=Muzzleflash/Big/LightningMuzzleBig
ShadowMuzzleBig=Muzzleflash/Big/ShadowMuzzleBig
StormMuzzleBig=Muzzleflash/Big/StormMuzzleBig
WaterMuzzleBig=Muzzleflash/Big/WaterMuzzleBig
ArcaneMuzzleNormal=Muzzleflash/Normal/ArcaneMuzzleNormal
EarthMuzzleNormal=Muzzleflash/Normal/EarthMuzzleNormal
FireMuzzleNormal=Muzzleflash/Normal/FireMuzzleNormal
FrostMuzzleNormal=Muzzleflash/Normal/FrostMuzzleNormal
LifeMuzzleNormal=Muzzleflash/Normal/LifeMuzzleNormal
LightMuzzleNormal=Muzzleflash/Normal/LightMuzzleNormal
LightningMuzzleNormal=Muzzleflash/Normal/LightningMuzzleNormal
ShadowMuzzleNormal=Muzzleflash/Normal/ShadowMuzzleNormal
StormMuzzleNormal=Muzzleflash/Normal/StormMuzzleNormal
WaterMuzzleNormal=Muzzleflash/Normal/WaterMuzzleNormal
ArcanePillarBlast=Pillar Blast/ArcanePillarBlast
EarthPillarBlast=Pillar Blast/EarthPillarBlast
FirePillarBlast=Pillar Blast/FirePillarBlast
FrostPillarBlast=Pillar Blast/FrostPillarBlast
LifePillarBlast=Pillar Blast/LifePillarBlast
LightningPillarBlast=Pillar Blast/LightningPillarBlast
LightPillarBlast=Pillar Blast/LightPillarBlast
ShadowPillarBlast=Pillar Blast/ShadowPillarBlast
StormPillarBlast=Pillar Blast/StormPillarBlast
WaterPillarBlast=Pillar Blast/WaterPillarBlast
ArcaneImpactMega=Projectiles/Arcane/ArcaneImpactMega
ArcaneImpactNormal=Projectiles/Arcane/ArcaneImpactNormal
ArcaneImpactSmall=Projectiles/Arcane/ArcaneImpactSmall
ArcaneImpactTiny=Projectiles/Arcane/ArcaneImpactTiny
ArcaneProjectileMega=Projectiles/Arcane/ArcaneProjectileMega
ArcaneProjectileNormal=Projectiles/Arcane/ArcaneProjectileNormal
ArcaneProjectileSmall=Projectiles/Arcane/ArcaneProjectileSmall
ArcaneProjectileTiny=Projectiles/Arcane/ArcaneProjectileTiny
EarthImpactMega=Projectiles/Earth/EarthImpactMega
EarthImpactNormal=Projectiles/Earth/EarthImpactNormal
EarthImpactSmall=Projectiles/Earth/EarthImpactSmall
EarthImpactTiny=Projectiles/Earth/EarthImpactTiny
EarthProjectileMega=Projectiles/Earth/EarthProjectileMega
EarthProjectileNormal=Projectiles/Earth/EarthProjectileNormal
EarthProjectileSmall=Projectiles/Earth/EarthProjectileSmall
EarthProjectileTiny=Projectiles/Earth/EarthProjectileTiny
FireImpactMega=Projectiles/Fire/FireImpactMega
FireImpactNormal=Projectiles/Fire/FireImpactNormal
FireImpactSmall=Projectiles/Fire/FireImpactSmall
FireImpactTiny=Projectiles/Fire/FireImpactTiny
FireProjectileMega=Projectiles/Fire/FireProjectileMega
FireProjectileNormal=Projectiles/Fire/FireProjectileNormal
FireProjectileSmall=Projectiles/Fire/FireProjectileSmall
FireProjectileTiny=Projectiles/Fire/FireProjectileTiny
FrostImpactMega=Projectiles/Frost/FrostImpactMega
FrostImpactNormal=Projectiles/Frost/FrostImpactNormal
FrostImpactSmall=Projectiles/Frost/FrostImpactSmall
FrostImpactTiny=Projectiles/Frost/FrostImpactTiny
FrostProjectileMega=Projectiles/Frost/FrostProjectileMega
FrostProjectileNormal=Projectiles/Frost/FrostProjectileNormal
FrostProjectileSmall=Projectiles/Frost/FrostProjectileSmall
FrostProjectileTiny=Projectiles/Frost/FrostProjectileTiny
FireProjectileLegacy=Projectiles/Legacy/FireProjectileLegacy
LightningImpactOld=Projectiles/Legacy/LightningImpactOld
LightningImpactSmallOld=Projectiles/Legacy/LightningImpactSmallOld
LightningProjectileOld=Projectiles/Legacy/LightningProjectileOld
LightningProjectileSmallOld=Projectiles/Legacy/LightningProjectileSmallOld
LifeImpactMega=Projectiles/Life/LifeImpactMega
LifeImpactNormal=Projectiles/Life/LifeImpactNormal
LifeImpactSmall=Projectiles/Life/LifeImpactSmall
LifeImpactTiny=Projectiles/Life/LifeImpactTiny
LifeProjectileMega=Projectiles/Life/LifeProjectileMega
LifeProjectileNormal=Projectiles/Life/LifeProjectileNormal
LifeProjectileSmall=Projectiles/Life/LifeProjectileSmall
LifeProjectileTiny=Projectiles/Life/LifeProjectileTiny
LightImpactMega=Projectiles/Light/LightImpactMega
LightImpactNormal=Projectiles/Light/LightImpactNormal
LightImpactSmall=Projectiles/Light/LightImpactSmall
LightImpactTiny=Projectiles/Light/LightImpactTiny
LightProjectileMega=Projectiles/Light/LightProjectileMega
LightProjectileNormal=Projectiles/Light/LightProjectileNormal
LightProjectileSmall=Projectiles/Light/LightProjectileSmall
LightProjectileTiny=Projectiles/Light/LightProjectileTiny
LightningImpactMega=Projectiles/Lightning/LightningImpactMega
LightningImpactNormal=Projectiles/Lightning/LightningImpactNormal
LightningImpactSmall=Projectiles/Lightning/LightningImpactSmall
LightningImpactTiny=Projectiles/Lightning/LightningImpactTiny
LightningProjectileMega=Projectiles/Lightning/LightningProjectileMega
LightningProjectileNormal=Projectiles/Lightning/LightningProjectileNormal
LightningProjectileNormal2=Projectiles/Lightning/LightningProjectileNormal2
LightningProjectileSmall=Projectiles/Lightning/LightningProjectileSmall
LightningProjectileTiny=Projectiles/Lightning/LightningProjectileTiny
ShadowImpactMega=Projectiles/Shadow/ShadowImpactMega
ShadowImpactNormal=Projectiles/Shadow/ShadowImpactNormal
ShadowImpactSmall=Projectiles/Shadow/ShadowImpactSmall
ShadowImpactTiny=Projectiles/Shadow/ShadowImpactTiny
ShadowProjectileMega=Projectiles/Shadow/ShadowProjectileMega
ShadowProjectileNormal=Projectiles/Shadow/ShadowProjectileNormal
ShadowProjectileSmall=Projectiles/Shadow/ShadowProjectileSmall
ShadowProjectileTiny=Projectiles/Shadow/ShadowProjectileTiny
StormImpactMega=Projectiles/Storm/StormImpactMega
StormImpactNormal=Projectiles/Storm/StormImpactNormal
StormImpactSmall=Projectiles/Storm/StormImpactSmall
StormImpactTiny=Projectiles/Storm/StormImpactTiny
StormProjectileMega=Projectiles/Storm/StormProjectileMega
StormProjectileNormal=Projectiles/Storm/StormProjectileNormal
StormProjectileSmall=Projectiles/Storm/StormProjectileSmall
StormProjectileTiny=Projectiles/Storm/StormProjectileTiny
WaterImpactMega=Projectiles/Water/WaterImpactMega
WaterImpactNormal=Projectiles/Water/WaterImpactNormal
WaterImpactSmall=Projectiles/Water/WaterImpactSmall
WaterImpactTiny=Projectiles/Water/WaterImpactTiny
WaterProjectileMega=Projectiles/Water/WaterProjectileMega
WaterProjectileNormal=Projectiles/Water/WaterProjectileNormal
WaterProjectileSmall=Projectiles/Water/WaterProjectileSmall
WaterProjectileTiny=Projectiles/Water/WaterProjectileTiny
ArcaneDome=Shields/Shield Dome/ArcaneDome
EarthDome=Shields/Shield Dome/EarthDome
FireDome=Shields/Shield Dome/FireDome
FrostDome=Shields/Shield Dome/FrostDome
LifeDome=Shields/Shield Dome/LifeDome
LightDome=Shields/Shield Dome/LightDome
LightningDome=Shields/Shield Dome/LightningDome
ShadowDome=Shields/Shield Dome/ShadowDome
StormDome=Shields/Shield Dome/StormDome
WaterDome=Shields/Shield Dome/WaterDome
ArcaneShield=Shields/Shield Sphere/ArcaneShield
EarthShield=Shields/Shield Sphere/EarthShield
FireShield=Shields/Shield Sphere/FireShield
FrostShield=Shields/Shield Sphere/FrostShield
LifeShield=Shields/Shield Sphere/LifeShield
LightningShield=Shields/Shield Sphere/LightningShield
LightShield=Shields/Shield Sphere/LightShield
ShadowShield=Shields/Shield Sphere/ShadowShield
SmoothShield=Shields/Shield Sphere/SmoothShield
SmoothShield2=Shields/Shield Sphere/SmoothShield2
StormShield=Shields/Shield Sphere/StormShield
WaterShield=Shields/Shield Sphere/WaterShield
ArcaneSlash=Slash/ArcaneSlash
EarthSlash=Slash/EarthSlash
FireSlash=Slash/FireSlash
FrostSlash=Slash/FrostSlash
LifeSlash=Slash/LifeSlash
LightningSlash=Slash/LightningSlash
LightSlash=Slash/LightSlash
ShadowSlash=Slash/ShadowSlash
StormSlash=Slash/StormSlash
WaterSlash=Slash/WaterSlash
ArcaneSphereBlast=SphereBlast/V1/ArcaneSphereBlast
EarthSphereBlast=SphereBlast/V1/EarthSphereBlast
FireSphereBlast=SphereBlast/V1/FireSphereBlast
FrostSphereBlast=SphereBlast/V1/FrostSphereBlast
LifeSphereBlast=SphereBlast/V1/LifeSphereBlast
LightningSphereBlast=SphereBlast/V1/LightningSphereBlast
LightSphereBlast=SphereBlast/V1/LightSphereBlast
ShadowSphereBlast=SphereBlast/V1/ShadowSphereBlast
StormSphereBlast=SphereBlast/V1/StormSphereBlast
WaterSphereBlast=SphereBlast/V1/WaterSphereBlast
ArcaneSphereBlastV2=SphereBlast/V2/ArcaneSphereBlastV2
EarthSphereBlastV2=SphereBlast/V2/EarthSphereBlastV2
FireSphereBlastV2=SphereBlast/V2/FireSphereBlastV2
FrostSphereBlastV2=SphereBlast/V2/FrostSphereBlastV2
LifeSphereBlastV2=SphereBlast/V2/LifeSphereBlastV2
LightningSphereBlastV2=SphereBlast/V2/LightningSphereBlastV2
LightSphereBlastV2=SphereBlast/V2/LightSphereBlastV2
ShadowSphereBlastV2=SphereBlast/V2/ShadowSphereBlastV2
StormSphereBlastV2=SphereBlast/V2/StormSphereBlastV2
WaterSphereBlastV2=SphereBlast/V2/WaterSphereBlastV2
ArcaneSpray=Sprays/ArcaneSpray
EarthSpray=Sprays/EarthSpray
FireSpray=Sprays/FireSpray
FrostSpray=Sprays/FrostSpray
LifeSpray=Sprays/LifeSpray
LightningSpray=Sprays/LightningSpray
LightningSprayNew=Sprays/LightningSprayNew
LightSpray=Sprays/LightSpray
ShadowSpray=Sprays/ShadowSpray
StormSpray=Sprays/StormSpray
WaterSpray=Sprays/WaterSpray
ArcaneWallCircle=Walls/Circular Wall/ArcaneWallCircle
EarthWallCircle=Walls/Circular Wall/EarthWallCircle
FireWallCircle=Walls/Circular Wall/FireWallCircle
FrostWallCircle=Walls/Circular Wall/FrostWallCircle
LifeWallCircle=Walls/Circular Wall/LifeWallCircle
LightningWallCircle=Walls/Circular Wall/LightningWallCircle
LightWallCircle=Walls/Circular Wall/LightWallCircle
ShadowWallCircle=Walls/Circular Wall/ShadowWallCircle
StormWallCircle=Walls/Circular Wall/StormWallCircle
WaterWallCircle=Walls/Circular Wall/WaterWallCircle
ArcaneWall=Walls/Straight Wall/ArcaneWall
EarthWall=Walls/Straight Wall/EarthWall
FireWall=Walls/Straight Wall/FireWall
FrostWall=Walls/Straight Wall/FrostWall
LifeWall=Walls/Straight Wall/LifeWall
LightningWall=Walls/Straight Wall/LightningWall
LightWall=Walls/Straight Wall/LightWall
ShadowWall=Walls/Straight Wall/ShadowWall
StormWall=Walls/Straight Wall/StormWall
WaterWall=Walls/Straight Wall/WaterWall
